11111111111
100000000E1
10011100001
1CC00011001
10001100001
10CCC000001
10000001001
10CCC0000C1
10C000000P1
1CCC110CC01
11111111111
