11111111111
100000000E1
10011100001
1CC1P100001
10011100001
10000000001
10000001001
100000000C1
10C00000001
10011100001
11111111111
